21
21
222222222222222222222
222222222000000000022
222222222000000000022
222222222000111110022
222222222000100010022
222222222000100010022
222222222000100010022
222222222000111110022
222222222000000000022
222222222000000000022
222222222000000000022
222222222222222222222
222222222222222222222
222222222222222222222
222222222222222222222
222222222222222222222
222222222222222222222
222222222222222222222
222222222222222222222
222222222222222222222
222222222222222222222
