10
10
1111111111
1020000001
1000000001
1000000001
1000000001
1000000001
1000000001
1000000001
1000000001
1111111111